03 03 02 03 01 03 03 00 00 00 03 02
01 02 00 02 00 02 01 02 01 00 01 00
02 02 03 01 02 01 03 00 03 00 00 00
03 02 00 01 00 03 01 09 40 37 12 03
01 01 02 00 02 01 02 57 60 29 20 02
03 03 02 03 01 03 01 56 60 45 01 00
00 01 03 03 00 02 00 23 52 16 03 00
00 01 03 00 02 03 01 01 01 00 02 01
03 01 01 01 02 01 02 00 00 01 01 01
03 00 00 03 02 02 03 02 00 01 02 02
01 01 00 03 01 02 02 03 00 01 00 02
00 03 01 03 00 00 00 00 03 01 01 03
00 00 03 02 01 02 00 01 03 02 01 03
03 00 00 01 01 01 01 00 02 03 02 00