01 03 02 03 03 00 00 02 02 00 01 00
02 02 00 00 00 01 07 10 02 02 03 03
02 03 00 03 03 00 59 42 00 02 02 02
01 01 00 03 03 06 33 35 12 01 03 00
01 02 01 00 08 32 60 60 46 01 00 03
00 00 01 06 32 60 61 61 34 11 03 01
01 01 05 33 62 60 61 61 63 43 01 03
01 01 23 31 60 61 61 73 28 21 01 00
03 00 01 26 30 61 61 29 21 00 01 00
01 03 03 03 59 65 68 43 03 02 01 01
01 01 00 01 56 60 28 20 01 00 00 02
01 01 03 01 55 60 44 03 01 03 02 00
02 00 01 03 23 49 20 02 01 03 03 01
03 02 02 01 03 03 03 03 03 00 01 02