00 00 00 00 00 00 00 00 00 00 00 00
00 00 00 00 00 00 00 00 00 00 00 00
00 00 00 00 00 00 00 00 00 00 05 40
00 00 00 00 00 08 36 37 41 39 33 60
00 00 06 37 40 33 60 60 60 60 61 61
37 38 33 60 60 61 60 60 61 61 61 61
60 60 60 66 68 61 60 69 62 72 60 60
60 60 60 60 60 60 60 29 48 49 53 49
31 63 60 61 28 50 52 17 00 00 00 00
32 66 60 60 47 00 00 00 00 00 00 00
62 67 60 29 19 00 00 00 00 00 00 00
73 28 50 20 00 00 00 00 00 00 00 00
49 16 00 00 00 00 00 00 00 00 00 00
00 00 00 00 00 00 00 00 00 00 00 00