01 01 01 00 00 02 01 03 01 00 02 03
00 03 01 03 02 03 00 02 00 02 00 00
02 00 03 00 02 00 00 03 01 03 02 02
00 01 01 01 03 02 00 00 00 01 00 02
03 03 03 00 03 02 00 01 02 01 00 01
03 00 01 02 00 02 05 37 12 00 01 00
02 01 02 00 00 01 59 60 34 10 03 01
03 00 03 01 02 01 54 60 60 44 02 02
02 05 37 14 01 00 23 31 29 20 00 00
00 56 61 46 01 03 02 26 17 00 01 00
03 23 49 20 02 03 00 03 00 02 00 03
00 01 03 02 03 01 02 02 02 02 02 02
00 00 00 00 03 00 02 01 03 00 00 01
01 02 00 02 02 00 02 01 03 00 00 02