01 00 03 02 00 01 03 01 03 03 03 02
00 00 01 01 02 02 03 00 03 01 01 01
00 01 00 01 03 01 00 00 00 03 03 00
01 03 01 03 03 02 00 03 00 02 02 03
01 02 05 38 40 41 37 14 03 03 03 02
02 03 22 30 61 60 60 44 03 02 01 01
03 01 00 22 30 60 69 35 37 13 03 01
02 01 02 02 55 60 65 66 28 17 02 02
00 02 00 01 24 49 49 50 20 01 02 00
03 02 01 01 02 01 01 00 03 03 01 03
01 01 01 03 00 02 03 03 03 00 00 02
02 02 02 01 03 01 03 02 00 00 01 00
03 03 00 00 01 01 01 00 01 00 03 00
02 03 01 01 02 00 00 00 00 03 00 03