00 03 00 03 03 01 03 00 03 01 00 03
02 05 37 11 00 00 00 03 02 00 01 03
00 54 60 34 10 00 02 00 01 02 03 01
01 55 61 60 43 02 03 01 03 00 03 01
00 22 52 49 20 01 02 03 01 02 03 00
01 00 02 00 01 01 02 02 02 02 03 01
03 03 03 00 03 00 01 01 02 03 00 01
00 01 03 02 02 01 03 03 01 07 14 01
01 00 01 01 03 02 00 01 00 55 43 01
00 00 03 00 00 03 02 03 05 32 35 11
02 03 03 03 03 01 03 03 22 49 49 16
03 03 02 00 01 02 02 02 03 02 00 02
01 00 02 03 01 00 03 00 02 00 01 01
02 02 01 02 01 02 01 03 01 03 01 00