01 02 02 01 01 00 02 03 03 00 03 02
02 01 02 03 00 02 01 00 00 07 36 37
03 00 01 02 03 01 01 00 02 59 65 60
02 03 00 00 03 02 00 02 03 27 30 60
00 02 00 00 09 11 02 00 00 00 22 50
01 01 05 37 33 45 03 01 03 02 03 02
00 08 32 61 28 16 00 00 02 01 01 03
00 25 31 73 44 01 02 00 02 00 00 01
03 00 55 70 35 10 02 01 03 01 02 00
02 00 22 50 52 18 03 03 03 00 01 02
02 01 02 02 00 03 03 03 04 11 00 02
03 00 02 02 02 00 00 03 26 16 03 02
01 01 01 02 00 03 02 00 00 03 02 01
02 02 01 01 00 00 03 01 01 03 02 00