03 03 03 03 02 03 01 01 01 02 01 01
01 02 06 36 37 38 15 01 03 02 00 00
01 03 59 62 70 60 46 00 02 02 03 01
01 03 56 60 60 60 47 02 02 00 00 01
03 03 57 60 73 61 34 14 02 01 02 01
01 01 26 49 30 61 61 43 01 01 02 02
01 01 02 00 23 31 68 47 03 00 03 02
01 02 03 03 01 59 60 34 15 01 01 01
03 00 02 02 03 58 66 65 45 02 00 03
02 01 03 02 01 22 50 31 44 01 00 00
03 02 01 00 02 01 00 25 16 02 03 00
02 01 01 03 01 01 03 02 02 02 01 02
01 01 00 03 00 01 02 00 00 03 00 00
01 02 02 01 02 01 00 03 00 02 01 00