00 00 01 00 00 03 02 03 01 03 01 03
03 00 00 02 02 03 02 02 01 03 01 03
03 03 02 00 01 03 01 02 00 02 02 02
03 03 00 01 03 03 01 00 01 01 03 02
02 01 02 03 02 00 01 03 01 08 40 41
02 01 03 01 03 00 01 01 02 23 31 69
02 03 01 01 03 02 03 00 01 02 56 65
01 01 03 02 03 03 01 02 00 03 23 30
02 03 01 02 01 00 01 03 03 03 03 25
03 00 03 02 02 02 02 02 01 00 01 00
01 00 03 03 01 00 02 00 00 00 03 03
02 00 00 01 00 03 02 00 03 02 01 03
01 03 00 00 03 00 00 00 01 02 02 00
01 02 03 03 02 02 00 00 01 01 02 00