02 02 02 03 02 00 01 02 01 02 00 03
01 02 00 00 01 01 00 01 00 02 01 02
00 01 02 01 02 01 00 09 39 13 01 01
02 00 03 00 03 03 08 33 61 47 02 02
00 00 03 01 00 00 24 52 49 21 01 02
01 01 02 01 03 00 00 02 01 02 02 03
01 01 01 03 02 00 03 03 01 00 03 02
03 02 02 03 01 03 00 08 15 00 00 02
02 00 03 00 01 03 03 23 21 00 00 01
03 03 01 03 04 10 00 03 00 02 03 00
01 03 02 03 26 17 00 01 02 00 02 02
02 00 03 02 03 01 00 03 03 03 02 02
01 01 00 03 01 01 02 00 00 03 01 03
02 00 01 01 01 02 03 01 01 03 02 03