01 02 01 03 01 00 03 03 01 02 03 01
02 03 00 00 00 05 12 00 00 00 02 02
01 03 02 09 39 33 47 00 00 00 03 01
04 41 40 33 60 60 34 37 13 03 03 01
32 60 60 60 68 69 60 60 47 03 03 02
60 60 65 67 63 60 60 60 44 03 03 02
60 60 60 62 73 29 50 52 20 03 01 03
48 49 31 72 60 47 03 03 02 00 03 01
01 00 27 30 60 45 03 03 02 02 01 03
02 01 01 54 60 42 03 01 00 00 01 00
00 01 02 25 52 18 00 01 01 01 00 02
03 03 00 03 00 02 03 03 01 08 11 02
03 03 03 03 01 01 00 01 03 24 17 02
03 00 00 01 03 00 01 03 02 02 01 01