03 02 00 03 03 03 02 01 02 03 01 01
01 03 00 09 38 14 01 03 00 01 00 00
03 03 05 32 65 34 36 41 37 12 01 00
03 00 22 30 60 60 63 70 61 34 14 03
03 01 02 23 53 30 62 29 31 61 34 36
01 03 02 00 02 59 60 44 27 30 60 60
00 01 02 02 00 23 31 34 38 32 60 60
02 01 03 00 02 03 59 61 64 61 60 70
00 00 01 02 01 03 24 52 50 30 60 62
00 00 01 03 01 03 01 03 00 23 30 60
00 00 03 00 03 02 01 00 01 02 56 60
01 03 02 01 03 02 02 00 03 01 25 48
03 00 01 01 03 02 01 02 01 01 02 03
01 01 03 03 03 02 01 03 01 03 00 01