00 03 05 37 37 12 02 00 02 01 01 00
41 40 32 60 60 34 14 02 01 01 00 01
60 60 60 28 51 31 42 03 01 00 00 01
60 62 29 20 03 59 43 01 02 00 01 00
60 60 45 03 02 23 20 02 01 03 01 02
60 60 44 03 03 03 01 00 01 03 01 02
60 60 45 01 04 11 03 00 00 00 01 01
62 70 34 11 22 19 03 01 02 02 03 01
60 72 66 35 36 14 00 02 03 03 00 02
29 53 52 48 49 20 01 02 02 02 00 00
18 00 01 00 03 00 02 00 03 02 00 01
01 03 01 00 03 02 00 01 02 03 03 00
00 03 01 02 00 03 00 02 00 00 02 02
01 03 02 00 03 03 01 02 03 03 00 00